abnehmen	nahmab	abgenommen	nimmstab
ausscheiden	schiedaus	ausgeschieden	scheidestaus
backen	backte	gebacken	bäckst
befehlen	befahl	befohlen	befiehlst
begehen	beging	begangen	begehst
beginnen	begann	begonnen	beginnst
beissen	biss	gebissen	beisst
bergen	barg	geborgen	birgst
bersten	barst	geborsten	birst
betrügen	betrog	betrogen	betrügst
bewegener	bewegte	bewegt	bewegst
biegen	bog	gebogen	biegst
bieten	bot	geboten	bietest
binden	band	gebunden	bindest
bitten	bat	gebeten	bittest
brechen	brach	gebrochen	brichst
denken	dachte	gedacht	denkst
empfehlen	empfahl	empfohl	enempfiehlst
erlöschen	erlosch	erloschen	es erlischt
erschrecken	erschrak	erschrocken	erschrickst
erwägen	erwog	erwogen	erwägst
fahren	fuhr	gefahren	fährst
fallen	fiel	gefallen	fällst
fechtenfochtgefochtenfichtst
flechtenflochtgeflochtenflichtst
fliehenflohgeflohenfliehst
gebärengebargeborengebierst/gebärst
gebengabgegebengibst
gedeihengediehgediehengedeihst
gehenginggegangengehstgelingengelanggelungengelingstgeltengaltgegoltengiltstgenesengenasgenesengenestgeniessengenossgenossengeniesstgiessengossgegossengiesstglimmenglommgeglommenglimmstgrabengrubgegrabengräbstgreifengriffgegriffengreifsthabenhattegehabthasthaltenhieltgehaltenhältst


